11111111111111111111111
15000000000000000000001
10111111111111111111101
10100000000000000000101
10101110111111101110101
10101010000000101010101
10101010111111101010101
10100010100000101000101
10111110101110101111101
10100000000012000000101
10101111111111111110101
10000000004000000000001
11111111111111111111111