11111111111111111111111
10000000000000000000001
10101110111111101110101
10101510100000101510101
10100000101110100000101
10111010101310101011101
10000010001310001000001
11101111131313111110111
11100013333333331000111
33331013111311131013333
11111033122222133011111
33331013111111131013333
11100013333333331000111
33101011131113111010133
11101000000000000010111
10001110101110101110001
10100000100000100000101
10111010111111101011101
10100010000400001000101
10101111101110111110101
15000000000100000000051
11111111111111111111111