1111133311111113111333331113111111133311111
1500133310000011100015100011100000133310051
1010001000111000000111110000001110001000101
1011100000010000010000000100000100000011101
1000001001000110011011101100110001001000001
1011101011101100110001000110011011101011101
1012100001000000000101010000000001000012101
1012300100010015101100011015100100010032101
1012101110111011100001000011101110111012101
1011100100000001000111110001000000010011101
1000000001011100010000000100011101000000001
1331010111000101010111110101010001110101331
1311010000010131311133311131310100000101131
1113011501110333333333333333330111051103111
3333001100000131311133311131310000011003333
3333300000111131312222222131311110000033333
3333001100000131311111111131310000011003333
1113011000110333333333333333330110001103111
1311010010011131111133311111311100100101131
1331010111010000000114110000000101110101331
1000000000010110510010100150110100000000001
1015011101000010111010101110100001011105101
1011001000011010010000000100101100001001101
1001101011010010000110110000100101101011001
1011000001010011100100010011100101000001101
1000011100010000001110111000000100011100001
1010000101111011000000000001101111010000101
1011110100000051010101010101500000010111101
1010000000111011011101011101101110000000101
1000133310000000000001000000000000133310001
1111133311111111111333331111111111133311111