11111111111111111111111
15000000000000000000001
10111111101113111111101
10150000001233100500101
10101110101113101110101
10101510000000101210101
10101011111111101310101
10100000000000003330101
10101111111111111110101
10000000000100000000001
11111111114111111111111