111113331111133311111
150000000010000000051
101110111010111011101
100000000000000000001
101110101111101011101
100000100010001000001
111110111313111011111
333310133333331013333
111110131131131011111
000000331323133000000
000000331222133000000
111110131111131011111
333310133333331013333
111110131111131011111
100000000010000000001
101110111010111011101
100010000040000010001
111010101111101010111
100000100010001000001
101111111010111111101
150000000000000000051
111113331111133311111
