11111111111111
10000050000001
10000000000001
10001131100001
10001232100001
10001111100001
10000040000001
11111111111111